TTTTTT G T GGGG T G TTTTTT
T    T              T    T
T R  T              T R  T
T    T              T    T
T                         .
T    T              T    T
T K  T              T K  T
T    T              T    T
TTTTTTTTTTTTTTTTTTTTTTTTTT